111111111111111111111111111111111111
100000101010100010001000100011000001
10101000100010C010101010101010010101
10P010100010101010100010100010000101
101010100010001010101010C01000101001
10101000C010101000100010101000101011
101010101010101010100010101011010101
100010100010101000101010101010000101
101010101010101010100010100001010101
101010100000100000001010101001010101
1010C0101010101010100010001001010C01
10101010C0101010001C1010101010010101
1010101010100010101010100010000101E1
111111111111111111111111111111111111