1111111111111111111111111111111111111111111
1ECCCCCCCCCCCCCCCCCCCCCCCCCCCCCCCCCCCCCCCC1
1CCC1CCCCCCC1CCCC1CCCCCCC1CCCC111111111CCC1
1CC11CCCCCCC11CC11CCCCCCC11CC11CCCCCCC11CC1
1CC1111CCC1111CC11CCCCCCC11CC111CCCCCCCCCC1
1CC11CC111CC11CCC111111111CCCCC11111111CCC1
1CC11CCC1CCC11CCCCCCCCCCC11CCCCCCCCCCC11CC1
1CC11CCCCCCC11CCCCCCCCCCC11CC11CCCCCCC11CC1
1CCC1CCCCCCC1CCCCCCCCCCCC1CCCC111111111CCC1
1PCCCCCCCCCCCCCCCCCCCCCCCCCCCCCCCCCCCCCCCC1
1111111111111111111111111111111111111111111
