111111111
100C00011
1P00000E1
100C00001
111111111