1111111
1P00EC1
1CC0001
1111111
